19 6
###################
#                 #
#1 ############## #
#  ###            #
#   2             #
###################
