10 10
##########
#        #
#1       #
#        #
#####    #
#        #
#        #
#        #
#   2    #
##########
